111111111111
100000000011
111001010001
101001000011
1P000000E011
101001001011
111001001011
1C0001001011
111111111111