111111111111
1E0000000011
111001010001
111001000011
1P0000000011
111001001011
111001001011
1C0001001011
111111111111